18 2
0
1
0 1277 1979 3273 5169 6933 4909 3872 2279 2648 2771 3511 3918 3980 3846 6434 5405 3980 
1277 0 1005 2074 3907 5666 3791 2866 1553 3025 2893 3554 3785 3600 3231 5477 4471 3600 
1979 1005 0 1372 3351 5382 2930 1912 616 2650 2342 2887 2996 2693 2250 4511 3493 2693 
3273 2074 1372 0 1985 4113 1757 1151 1539 3773 3337 3679 3569 3006 2300 3601 2681 3006 
5169 3907 3351 1985 0 2323 1548 2274 3488 5666 5178 5377 5118 4419 3647 3233 2792 4419 
6933 5666 5382 4113 2323 0 3795 4594 5651 7884 7428 7678 7438 6743 5971 5073 4930 6743 
4909 3791 2930 1757 1548 3795 0 1154 2782 4676 4128 4162 3803 3062 2315 1954 1274 3062 
3872 2866 1912 1151 2274 4594 1154 0 1659 3540 3005 3119 2843 2158 1387 2611 1616 2158 
2279 1553 616 1539 3488 5651 2782 1659 0 2243 1851 2323 2391 2079 1680 4160 3130 2079 
2648 3025 2650 3773 5666 7884 4676 3540 2243 0 578 1099 1680 2171 2572 5449 4500 2171 
2771 2893 2342 3337 5178 7428 4128 3005 1851 578 0 741 1228 1618 1994 4872 3922 1618 
3511 3554 2887 3679 5377 7678 4162 3119 2323 1099 741 0 601 1248 1868 4599 3728 1248 
3918 3785 2996 3569 5118 7438 3803 2843 2391 1680 1228 601 0 756 1490 4060 3236 756 
3980 3600 2693 3006 4419 6743 3062 2158 2079 2171 1618 1248 756 0 772 3351 2491 0 
3846 3231 2250 2300 3647 5971 2315 1387 1680 2572 1994 1868 1490 772 0 2892 1928 772 
6434 5477 4511 3601 3233 5073 1954 2611 4160 5449 4872 4599 4060 3351 2892 0 1030 3351 
5405 4471 3493 2681 2792 4930 1274 1616 3130 4500 3922 3728 3236 2491 1928 1030 0 2491 
3980 3600 2693 3006 4419 6743 3062 2158 2079 2171 1618 1248 756 0 772 3351 2491 0 
